22 18
Examples/BeachStones

Objects
D cube.mesh 0.0 2.0 0.0   0.0 0.02


Characters
C ninja.mesh 0.0 0.0 0.0  0.0 0.15

World
WWWWWWWWWWWWWWWWWW
WP...............W
W................W
W................W
W................W
W................W
W................W
W................W
W................W
W................W
W................W
W................W
W................W
W................W
W................W
W................W
W................W
WWWWWWWWWWWWWWWWWW
