50 50
Examples/BeachStones

Objects
D cube.mesh 0.0 2.0 0.0   0.0 0.02


Characters
C ninja.mesh 0.0 0.0 0.0  0.0 0.15

World
WWWWWWWWWWWWWWWWWWWWWWWWWWWWWWWWWWWWWWWWWWWWWWWWW
WWWWWWWWWWWWWWAWA.......WWWWWWWWWWWWWWWWWWWW....E
WWWWWWW.........W.....WWWWWW.............WWW...WW
WWWWWWW..A....A..A....WWWWWWWWWWWWWWWW......WWWWW
WWWWWW.AWWWWWWW....WWWWWWWWWWWWWWWWWWWWWWWWWWWWWW
WWWWW...W...WWW....WWWWWWWWWWWWWWWWWWWWWWWWWWWWWW
WWWW......A.WW.....WWWWWWWWWWWWWWWWWWWWWWWWWWWWWW
WWWW....AWW..WW....WWWWWWWWWWWWWWWWWWWWWWWWWWWWWW
WWWWA...WW..A.AWAWWWWWWWWWWWWWWWWWWWWWWWWWWWWWWWW
WWWW....WWWW......WWWWWWWWWWWWWWWWWWWWWWWWWWWWWWW
WWWW....W..A..H...WWWWWWWWWWWWWWWWWWWWWWWWWWWWWWW
WWWW....A.C.A.....WWWWWWWWWWWWWWWWWWWWWWWWWWWWWWW
WWWW..W..W.W...W..WWWWWWWWWWWWWWWWWWWWWWWWWWWWWWW
WWWW..W..W...W..WAWWWWWWWWWWWWWWWWWWWWWWWWWWWWWWW
WWWWWWWWWW....WWW.WWWWWWWWWWWWWWWWWWWWWWWWWWWWWWW
WWW....W.....WWW......WWWWWWWWWWWWWWWWWWWWWWWWWWW
WWW....A....A.......A.WWWWWWWWWWWWWWWWWWWWWWWWWWW
WWW.....WWWCWW.W..WWWWWWWWWWWWWWWWWWWWWWWWWWWWWWW
WWW.....WWW.WW.WA.WWWWWWWWWWWWWWWWWWWWWWWWWWWWWWW
WWW.....WWW.WW.W.WWWWWWWWWWWWWWWWWWWWWWWWWWWWWWWW
WWW.....WWWAWWWW..WWWWWWWWWWWWWWWWWWWWWWWWWWWWWWW
WWW.....WWW...............................WWWWWWW
WWWWWWWWWWWWWWWWW......WWWWWWWWWWWWWWWWWWWWWWWWWW
WWWWWWWWWWWWWWWWWW...WWWWWWWWWWWWWWWWWWWWWWWWWWWW
WWWWWWWWWWWWWWWWW.......WWWWWWWWWWWWWWWWWWWWWWWWW
WWWWWWWWWWWWWWWWW.......WWWWWWWWWWWWWWWWWWWWWWWWW
WWWWWWWWWWWWWWAWA.......WWWWWWWWWWWWWWWWWWWWWWWWW
WWWWWWW.........W.....WWWWWWWWWWWWWWWWWWWWWWWWWWW
WWWWWWW..A....A..A....WWWWWWWWWWWWWWWWWWWWWWWWWWW
WWWWWW.AWWWWWWW....WWWWWWWWWWWW......WWWWWWWWWWWW
WWWWW...W...WWW....WWWWWWWWWWWWW...WWWWWWWWWWWWWW
WWWW......A.WW.....WWWWWWWWWWWWWWWWWWWWWWWWWWWWWW
WWWW....AWW..WW....WWWWWWWWWWWWWWWWWWWWWWWWWWWWWW
WWWWA...WW..A.AWAWWWWWWWWWWWWWWWWWWWWWWWWWWWWWWWW
WWWW....WWWW......WWWWWWWWWWWWWWWWWWWWWWWWWWWWWWW
WWWW....W..A......WWWWWWWWWWWWWWWWWWWWWWWWWWWWWWW
WWWW....A.C.A.....WWWWWWWWWWWWWWWWWWWWWWWWWWWWWWW
WWWW..W..W.W...W................WWWWWWWWWWWWWWWWW
WWWW..W..W...W..WAWWWWWWWWWWWWWWWWWWWWWWWWWWWWWWW
WWWWWWWWWW....WWW.WWWWWWWWWWWWWWWWWWWWWWWWWWWWWWW
WWW....W.....WWW......WWWWWWWWWWWWWWWWWWWWWWWWWWW
WWW....A....A.......A.WWWWWWWWWW.........WWWWWWWW
WWW.....WWWCWW.W..WWWWWWWWWWWWWWW....WWWWWWWWWWWW
WWW.....WWW.WW.WA.WWWWWWWWWWWWWWW...WWWWWWWWWWWWW
WWW.....WWW.WW.W.WWWWWWWWWWWWWWW.....WWWWWWWWWWWW
WWW.P...WWWAWWWW.......................WWWWWWWWWW
WWW.....WWW.............................WWWWWWWWW
WWWWWWWWWWWWWWWWWWWWWWWWWWWWWWWWWWWWWWWWWWWWWWWWW
WWWWWWWWWWWWWWWWWWWWWWWWWWWWWWWWWWWWWWWWWWWWWWWWW
WWWWWWWWWWWWWWWWWWWWWWWWWWWWWWWWWWWWWWWWWWWWWWWWW