17 20
Examples/BeachStones

Objects
D cube.mesh 0.0 2.0 0.0   0.0 0.02


Characters
C ninja.mesh 0.0 0.0 0.0  0.0 0.15

World
WWWWWWWW..WW..WWW
WWWWWWWW..WW..WWW
WWWWWWWW..WW..WWW
WWWWWWWW......WWW
WWWWWWW.......WWW
WWW......C....WWW
WW..S.........WWW
WW...........HWW
WW..WWWWWWWWWWWWW
WW..WWWWWWWWWWWWW
WW..WWWWWWWWWWWWW
WW..WWWWWWWWWWWWW
WW..WWWWWWWWWWWWW
WW..WWWWWWWWWWWWW
WW..WWWWWWWWWWWWW
WW..WWWWWWWWWWWWW
WW..WWWWWWWWWWWWW
