100 100
Examples/BeachStones

Objects
D cube.mesh 0.0 2.0 0.0   0.0 0.02


Characters
C ninja.mesh 0.0 0.0 0.0  0.0 0.15

World
WWWWWWWWWWWWWWWWWWWWWWWWWWWWWWWWWWWWWWWWWWWWWWWWWWWWWWWWWWWWWWWWWWWWWWWWWWWWWWWWWWWWWWWWWWWWWWWWWWWW
WWWWWWWWWWWWWWWWWAWA......................WWWWWWWWWWWW............A............WWWWWWWWWWWWWWWWWWWWW
WWWWWWWWWW........W....WWWWWWWWWWWWWWWWWWWWWWWWWWWWWWWWWWWWWWWWWWWWWWWWWWWW........A...............E
WWWWWWWWWW.a....a..a...WWWWWWWWWWWWWWWWWWWWWWWWWWWWWWWWWWWWWWWWWWWWWWWWWWWW..a....WWWWWWWWWWWWWWWWWW
WWWWWWWWW.AWWWWWWW..WWWWWWWWWWWWWWWWWWWWWWWWWWWWWWWWWWWWWWWWWWWWWWWWWWWWWWW..a....WWWWWWWWWWWWWWWWWW
WWWWWWWW...W..WWW...WWWWWWWWWWWWWWWWWWWWWWWWWWWWWWWWWWWWWWWWWWWWWWWWWWWWWWW..a....WWWWWWWWWWWWWWWWWW
WWWWWWW......a.WW...WWWWWWWWWWWWWWWWWWWWWWWWWWWWWWWWWWWWWWWWWWWWWWWWWWWWWWW..a....WWWWWWWWWWWWWWWWWW
WWWWWWW....AWW.WW...WWWWWWWWWWWWWWWWWWWWWWWWWWWWWWWWWWWWWWWWWWWWWWWWWWWWWWW..a....WWWWWWWWWWWWWWWWWW
WWWWWWWA.WW..a.AWAWWWWWWWWWWWWWWWWWWWWWWWWWWWWWWWWWWWWWWWWWWWWWWWWWWWWWWWWW..a....WWWWWWWWWWWWWWWWWW
WWWWWWW..WWWW......WWWWWWWWWWWWWWWWWWWWWWWWWWWWWWWWWWWWWWWWWWWWWWWWWWWWWWWW..a....WWWWWWWWWWWWWWWWWW
WWWWWWW..W..a..C...WWWWWWWWWWWWWWWWWWWWWWWWWWWWWWWWWWWWWWWWWWWWWWWWWWWWWWWW..a....WWWWWWWWWWWWWWWWWW
WWWWWWW..a.C.A.....WWWWWWWWWWWWWWWWWWWWWWWWWWWWWWWWWWWWWWWWWWWWWWWWWWWWWWWW..a....WWWWWWWWWWWWWWWWWW
WWWWWWW..W..W.W.W..WWWWWWWWWWWWWWWWWWWWWWWWWWWWWWWWWWWWWWWWWWWWWWWWWWWWWWWW..a....WWWWWWWWWWWWWWWWWW	
WWWWWWW..W..W.W..WAWWWWWWWWWWWWWWWWWWWWWWWWWWWWWWWWWWWWWWWWWWWWWWWWWWWWWWWW..a....WWWWWWWWWWWWWWWWWW
WWWWWWWWWWWWW..WWW.WWWWWWWWWWWWWWWWWWWWWWWWWWWWWWWWWWWWWWWWWWWWWWWWWWWWWWWW..a....WWWWWWWWWWWWWWWWWW
WWWWWW...W.....WWW.....WWWWWWWWWWWWWWWWWWWWWWWWWWWWWWWWWWWWWWWWWWWWWWWWWWWW..a....WWWWWWWWWWWWWWWWWW
WWWWWW...a...a.......a.WWWWWWWWWWWWWWWWWWWWWWWWWWWWWWWWWWWWWWWWWWWWWWWWWWWW..a....WWWWWWWWWWWWWWWWWW
WWWWWW..WWWCWW.W..WWWWWWWWWWWWWWWWWWWWWWWWWWWWWWWWWWWWWWWWWWWWWWWWWWWWWWWWW..a....WWWWWWWWWWWWWWWWWW
WWWWWW..WWW.WW.WA.WWWWWWWWWWWWWWWWWWWWWWWWWWWWWWWWWWWWWWWWWWWWWWWWWWWWWWWWW..a....WWWWWWWWWWWWWWWWWW
WWWWWW..WWW.WW.W.WWWWWWWWWWWWWWWWWWWWWWWWWWWWWWWWWWWWWWWWWWWWWWWWWWWWWWWWWW..a....WWWWWWWWWWWWWWWWWW
WWWWWW..WWWAWWWW..WWWWWWWWWWWWWWWWWWWWWWWWWWWWWWWWWWWWWWWWWWWWWWWWWWWWWWWWW..a....WWWWWWWWWWWWWWWWWW
WWWWWW..WWW.......WWWWWWWWWWWWWWWWWWWWWWWWWWWWWWWWWWWWWWWWWWWWWWWWWWWWWWWWW..a....WWWWWWWWWWWWWWWWWW
WWWWWW..WWWWWWWWWWWWWWWWWWWWWWWWWWWWWWWWWWWWWWWWWWWWWWWWWWWWWWWWWWWWWWWWWWW..a....WWWWWWWWWWWWWWWWWW
WWWWWWWWWWWWWWWWWWWWWWWWWWWWWWWWWWWWWWWWWWWWWWWWWWWWWWWWWWWWWWWWWWWWWWWWWWW..a....WWWWWWWWWWWWWWWWWW
WWWWWWWWWWWWWWWWWAWA...WWWWWWWWWWWWWWWWWWWWWWWWWWWWWWWWWWWWWWWWWWWWWW..a....WWWWWWWWWWWWWWWWWWWWWWWW
WWWWWWWWWW........W....WWWWWWWWWWWWWWWWWWWWWWWWWWWWWWWWWWWWWWWWWWWWWWWWWWWW..a....WWWWWWWWWWWWWWWWWW
WWWWWWWWWW.a....a..a...WWWWWWWWWWWWWWWWWWWWWWWWWWWWWWWWWWWWWWWWWWWWWWWWWWWW..a....WWWWWWWWWWWWWWWWWW
WWWWWWWWW.AWWWWWWW..WWWWWWWWWWWWWWWWWWWWWWWWWWWWWWWWWWWWWWWWWWWWWWWWWWWWWWW..a....WWWWWWWWWWWWWWWWWW
WWWWWWWW...W..WWW...WWWWWWWWWWWWWWWWWWWWWWWWWWWWWWWWWWWWWWWWWWWWWWWWWWWWWWW..a....WWWWWWWWWWWWWWWWWW
WWWWWWW......a.WW...WWWWWWWWWWWWWWWWWWWWWWWWWWWWWWWWWWWWWWWWWWWWWWWWWWWWWWW..a....WWWWWWWWWWWWWWWWWW
WWWWWWW....AWW.WW...WWWWWWWWWWWWWWWWWWWWWWWWWWWWWWWWWWWWWWWWWWWWWWWWWWWWWWW..a....WWWWWWWWWWWWWWWWWW
WWWWWWWA.WW..a.AWAWWWWWWWWWWWWWWWWWWWWWWWWWWWWWWWWWWWWWWWWWWWWWWWWWWWWWWWWW..a....WWWWWWWWWWWWWWWWWW
WWWWWWW..WWWW......WWWWWWWWWWWWWWWWWWWWWWWWWWWWWWWWWWWWWWWWWWWWWWWWWWWWWWWW..a....WWWWWWWWWWWWWWWWWW
WWWWWWW..W..a..C...WWWWWWWWWWWWWWWWWWWWWWWWWWWWWWWWWWWWWWWWWWWWWWWWWWWWWWWW..a....WWWWWWWWWWWWWWWWWW
WWWWWWW..a.C.A.....WWWWWWWWWWWWWWWWWWWWWWWWWWWWWWWWWWWWWWWWWWWWWWWWWWWWWWWW..a....WWWWWWWWWWWWWWWWWW
WWWWWWW..W..W.W.W..WWWWWWWWWWWWWWWWWWWWWWWWWWWWWWWWWWWWWWWWWWWWWWWWWWWWWWWWW..a....WWWWWWWWWWWWWWWWW
WWWWWWW..W..W.W..WAWWWWWWWWWWWWWWWWWWWWWWWWWWWWWWWWWWWWWWWWWWWWWWWWWWWWWWWW..a....WWWWWWWWWWWWWWWWWW
WWWWWWWWWWWWW..WWW.WWWWWWWWWWWWWWWWWWWWWWWWWWWWWWWWWWWWWWWWWWWWWWWWWWWWWWWW..a....WWWWWWWWWWWWWWWWWW
WWWWWW...W.....WWW.....WWWWWWWWWWWWWWWWWWWWWWWWWWWWWWWWWWWWWWWWWWWWWWWWWWWW..a....WWWWWWWWWWWWWWWWWW
WWWWWW...a...a.......a.WWWWWWWWWWWWWWWWWWWWWWWWWWWWWWWWWWWWWWWWWWWWWWWWWWWW..a....WWWWWWWWWWWWWWWWWW
WWWWWW..WWWCWW.W..WWWWWWWWWWWWWWWWWWWWWWWWWWWWWWWWWWWWWWWWWWWWWWWWWWWWWWWWW..a....WWWWWWWWWWWWWWWWWW
WWWWWW..WWW.WW.WA.WWWWWWWWWWWWWWWWWWWWWWWWWWWWWWWWWWWWWWWWWWWWWWWWWWWWWWWWW..a....WWWWWWWWWWWWWWWWWW
WWWWWW..WWW.WW.W.WWWWWWWWWWWWWWWWWWWWWWWWWWWWWWWWWWWWWWWWWWWWWWWWWWWWWWWWWW..a....WWWWWWWWWWWWWWWWWW
WWWWWW..WWWAWWWW..WWWWWWWWWWWWWWWWWWWWWWWWWWWWWWWWWWWWWWWWWWWWWWWWWWWWWWWWW..a....WWWWWWWWWWWWWWWWWW
WWWWWW..WWW.......WWWWWWWWWWWWWWWWWWWWWWWWWWWWWWWWWWWWWWWWWWWWWWWWWWWWWWWWW..a....WWWWWWWWWWWWWWWWWW
WWWWWW..WWWWWWWWWWWWWWWWWWWWWWWWWWWWWWWWWWWWWWWWWWWWWWWWWWWWWWWWWWWWWWWWWWW..a....WWWWWWWWWWWWWWWWWW
WWWWWWWWWWWWWWWWWWWWWWWWWWWWWWWWWWWWWWWWWWWWWWWWWWWWWWWWWWWWWWWWWWWWWWWWWWW..a....WWWWWWWWWWWWWWWWWW
WWWWWWWWWWWWWWWWWAWA...WWWWWWWWWWWWWWWWWWWWWWWWWWWWWWWWWWWWWWWWWWWWWW..a....WWWWWWWWWWWWWWWWWWWWWWWW
WWWWWWWWWW........W....WWWWWWWWWWWWWWWWWWWWWWWWWWWWWWWWWWWWWWWWWWWWWWWWWWWW..a....WWWWWWWWWWWWWWWWWW
WWWWWWWWWW.a....a..a...WWWWWWWWWWWWWWWWWWWWWWWWWWWWWWWWWWWWWWWWWWWWWWWWWWWW..a....WWWWWWWWWWWWWWWWWW
WWWWWWWWW.AWWWWWWW..WWWWWWWWWWWWWWWWWWWWWWWWWWWWWWWWWWWWWWWWWWWWWWWWWWWWWWW..a....WWWWWWWWWWWWWWWWWW
WWWWWWWW...W..WWW...WWWWWWWWWWWWWWWWWWWWWWWWWWWWWWWWWWWWWWWWWWWWWWWWWWWWWWW..a....WWWWWWWWWWWWWWWWWW
WWWWWWW......a.WW...WWWWWWWWWWWWWWWWWWWWWWWWWWWWWWWWWWWWWWWWWWWWWWWWWWWWWWW..a....WWWWWWWWWWWWWWWWWW
WWWWWWW....AWW.WW...WWWWWWWWWWWWWWWWWWWWWWWWWWWWWWWWWWWWWWWWWWWWWWWWWWWWWWW..a....WWWWWWWWWWWWWWWWWW
WWWWWWWA.WW..a.AWAWWWWWWWWWWWWWWWWWWWWWWWWWWWWWWWWWWWWWWWWWWWWWWWWWWWWWWWWW..a....WWWWWWWWWWWWWWWWWW
WWWWWWW..WWWW......WWWWWWWWWWWWWWWWWWWWWWWWWWWWWWWWWWWWWWWWWWWWWWWWWWWWWWWW..a....WWWWWWWWWWWWWWWWWW
WWWWWWW..W..a..C...WWWWWWWWWWWWWWWWWWWWWWWWWWWWWWWWWWWWWWWWWWWWWWWWWWWWWWWW..a....WWWWWWWWWWWWWWWWWW
WWWWWWW..a.C.A.....WWWWWWWWWWWWWWWWWWWWWWWWWWWWWWWWWWWWWWWWWWWWWWWWWWWWWWWW..a....WWWWWWWWWWWWWWWWWW
WWWWWWW..W..W.W.W..WWWWWWWWWWWWWWWWWWWWWWWWWWWWWWWWWWWWWWWWWWWWWWWWWWWWWWWWW..a....WWWWWWWWWWWWWWWWW
WWWWWWW..W..W.W..WAWWWWWWWWWWWWWWWWWWWWWWWWWWWWWWWWWWWWWWWWWWWWWWWWWWWWWWWW..a....WWWWWWWWWWWWWWWWWW
WWWWWWWWWWWWW..WWW.WWWWWWWWWWWWWWWWWWWWWWWWWWWWWWWWWWWWWWWWWWWWWWWWWWWWWWWW..a....WWWWWWWWWWWWWWWWWW
WWWWWW...W.....WWW.....WWWWWWWWWWWWWWWWWWWWWWWWWWWWWWWWWWWWWWWWWWWWWWWWWWWW..a....WWWWWWWWWWWWWWWWWW
WWWWWW...a...a.......a.WWWWWWWWWWWWWWWWWWWWWWWWWWWWWWWWWWWWWWWWWWWWWWWWWWWW..a....WWWWWWWWWWWWWWWWWW
WWWWWW..WWWCWW.W..WWWWWWWWWWWWWWWWWWWWWWWWWWWWWWWWWWWWWWWWWWWWWWWWWWWWWWWWW..a....WWWWWWWWWWWWWWWWWW
WWWWWW..WWW.WW.WA.WWWWWWWWWWWWWWWWWWWWWWWWWWWWWWWWWWWWWWWWWWWWWWWWWWWWWWWWW..a....WWWWWWWWWWWWWWWWWW
WWWWWW..WWW.WW.W.WWWWWWWWWWWWWWWWWWWWWWWWWWWWWWWWWWWWWWWWWWWWWWWWWWWWWWWWWW..a....WWWWWWWWWWWWWWWWWW
WWWWWW..WWWAWWWW..WWWWWWWWWWWWWWWWWWWWWWWWWWWWWWWWWWWWWWWWWWWWWWWWWWWWWWWWW..a....WWWWWWWWWWWWWWWWWW
WWWWWW..WWW.......WWWWWWWWWWWWWWWWWWWWWWWWWWWWWWWWWWWWWWWWWWWWWWWWWWWWWWWWW..a....WWWWWWWWWWWWWWWWWW
WWWWWW..WWWWWWWWWWWWWWWWWWWWWWWWWWWWWWWWWWWWWWWWWWWWWWWWWWWWWWWWWWWWWWWWWWW..a....WWWWWWWWWWWWWWWWWW
WWWWWWWWWWWWWWWWWWWWWWWWWWWWWWWWWWWWWWWWWWWWWWWWWWWWWWWWWWWWWWWWWWWWWWWWWWW..a....WWWWWWWWWWWWWWWWWW
WWWWWWWWWWWWWWWWWAWA...WWWWWWWWWWWWWWWWWWWWWWWWWWWWWWWWWWWWWWWWWWWWWW..a....WWWWWWWWWWWWWWWWWWWWWWWW
WWWWWWWWWW........W....WWWWWWWWWWWWWWWWWWWWWWWWWWWWWWWWWWWWWWWWWWWWWWWWWWWW..a....WWWWWWWWWWWWWWWWWW
WWWWWWWWWW.a....a..a...WWWWWWWWWWWWWWWWWWWWWWWWWWWWWWWWWWWWWWWWWWWWWWWWWWWW..a....WWWWWWWWWWWWWWWWWW
WWWWWWWWW.AWWWWWWW..WWWWWWWWWWWWWWWWWWWWWWWWWWWWWWWWWWWWWWWWWWWWWWWWWWWWWWW..a....WWWWWWWWWWWWWWWWWW
WWWWWWWW...W..WWW...WWWWWWWWWWWWWWWWWWWWWWWWWWWWWWWWWWWWWWWWWWWWWWWWWWWWWWW..a....WWWWWWWWWWWWWWWWWW
WWWWWWW......a.WW...WWWWWWWWWWWWWWWWWWWWWWWWWWWWWWWWWWWWWWWWWWWWWWWWWWWWWWW..a....WWWWWWWWWWWWWWWWWW
WWWWWWW....AWW.WW...WWWWWWWWWWWWWWWWWWWWWWWWWWWWWWWWWWWWWWWWWWWWWWWWWWWWWWW..a....WWWWWWWWWWWWWWWWWW
WWWWWWWA.WW..a.AWAWWWWWWWWWWWWWWWWWWWWWWWWWWWWWWWWWWWWWWWWWWWWWWWWWWWWWWWWW..a....WWWWWWWWWWWWWWWWWW
WWWWWWW..WWWW......WWWWWWWWWWWWWWWWWWWWWWWWWWWWWWWWWWWWWWWWWWWWWWWWWWWWWWWW..a....WWWWWWWWWWWWWWWWWW
WWWWWWW..W..a..C...WWWWWWWWWWWWWWWWWWWWWWWWWWWWWWWWWWWWWWWWWWWWWWWWWWWWWWWW..a....WWWWWWWWWWWWWWWWWW
WWWWWWW..a.C.A.....WWWWWWWWWWWWWWWWWWWWWWWWWWWWWWWWWWWWWWWWWWWWWWWWWWWWWWWW..a....WWWWWWWWWWWWWWWWWW
WWWWWWW..W..W.W.W..WWWWWWWWWWWWWWWWWWWWWWWWWWWWWWWWWWWWWWWWWWWWWWWWWWWWWWWWW..a....WWWWWWWWWWWWWWWWW
WWWWWWW..W..W.W..WAWWWWWWWWWWWWWWWWWWWWWWWWWWWWWWWWWWWWWWWWWWWWWWWWWWWWWWWW..a....WWWWWWWWWWWWWWWWWW
WWWWWWWWWWWWW..WWW.WWWWWWWWWWWWWWWWWWWWWWWWWWWWWWWWWWWWWWWWWWWWWWWWWWWWWWWW..a....WWWWWWWWWWWWWWWWWW
WWWWWW...W.....WWW.....WWWWWWWWWWWWWWWWWWWWWWWWWWWWWWWWWWWWWWWWWWWWWWWWWWWW..a....WWWWWWWWWWWWWWWWWW
WWWWWW...a...a.......a.WWWWWWWWWWWWWWWWWWWWWWWWWWWWWWWWWWWWWWWWWWWWWWWWWWWW..a....WWWWWWWWWWWWWWWWWW
WWWWWW..WWWCWW.W..WWWWWWWWWWWWWWWWWWWWWWWWWWWWWWWWWWWWWWWWWWWWWWWWWWWWWWWWW..a....WWWWWWWWWWWWWWWWWW
WWWWWW..WWW.WW.WA.WWWWWWWWWWWWWWWWWWWWWWWWWWWWWWWWWWWWWWWWWWWWWWWWWWWWWWWWW..a....WWWWWWWWWWWWWWWWWW
WWWWWW..WWW.WW.W.WWWWWWWWWWWWWWWWWWWWWWWWWWWWWWWWWWWWWWWWWWWWWWWWWWWWWWWWWW..a....WWWWWWWWWWWWWWWWWW
WWWWWW..WWWAWWWW..WWWWWWWWWWWWWWWWWWWWWWWWWWWWWWWWWWWWWWWWWWWWWWWWWWWWWWWWW..a....WWWWWWWWWWWWWWWWWW
WWWWWW.WWW.......WWWWWWWWWWWWWWWWWWWWWWWWWWWWWWWWWWWWWWWWWWWWWWWWWWWWWWWWW..a....WWWWWWWWWWWWWWWWWWW
WWWWWW..WWWWWWWWWWWWWWWWWWWWWWWWWWWWWWWWWWWWWWWWWWWWWWWWWWWWWWWWWWWWWWWWWWW..a....WWWWWWWWWWWWWWWWWW
WWWWWWWWWWWWWWWWWWWWWWWWWWWWWWWWWWWWWWWWWWWWWWWWWWWWWWWWWWWWWWWWWWWWWWWWWWW..a....WWWWWWWWWWWWWWWWWW
WWWWWWWWWWWWWWWWWAWA...WWWWWWWWWWWWWWWWWWWWWWWWWWWWWWWWWWWWWWWWWWWWWWWWWWWW..a....WWWWWWWWWWWWWWWWWW
WWWWWWWWWW........W....WWWWWWWWWWWWWWWWWWWWWWWWWWWWWWWWWWWWWWWWWWWWWWWWWWWW..a....WWWWWWWWWWWWWWWWWW
WWWWWWWWWW.a....a..a...WWWWWWWWWWWWWWWWWWWWWWWWWWWWWWWWWWWWWWWWWWWWWWWWWWWW..a....WWWWWWWWWWWWWWWWWW
WWWWWWWWW.AWWWWWWW..WWWWWWWWWWWWWWWWWWWWWWWWWWWWWWWWWWWWWWWWWWWWWWWWWWWWWWW..a....WWWWWWWWWWWWWWWWWW
WWWWWWWW...W..WWW...WWWWWWWWWWWWWWWWWWWWWWWWWWWWWWWWWWWWWWWWWWWWWWWWWWWWWWW..a....WWWWWWWWWWWWWWWWWW
WWWWWWW..C...a.WW...WWWWWWWWWWWWWWWWWWWWWWWWWWWWWWWWWWWWWWWWWWWWWWWWWWWWWWW..a....WWWWWWWWWWWWWWWWWW
WWWWWWWP...AWW.WW...WWWWWWWWWWWWWWWWWWWWWWWWWWWWWWWWWWWWWWWWWWWWWWWWWWWWWWW..a....WWWWWWWWWWWWWWWWWW
