2000 1700
Examples/WaterStream

Objects
C angel.mesh   // size and location specified here as well

World
WWWWWWWWWWWXXXWWW
WWWWWWWWWWWAWAWWE
WWWWXAXXXXAXAXXXX
WWWXAWWWWWWWXWWWW
WWXXXWXWWWXXXWWWW
WXXXXXAXWWXXXWWWW
WXXXAWWXWWXXXWWWW
WAWWXXAXAWAWWWWWW
WXXWWWWXXXXXWWWWW
WXXWXXAXXCXXWWWWW
WXXAXCXAXXXXWWWWW
WXXWXXWXWXWXWWWWW
WXXWXXWXWXWAWWWWW
WWWWWWWXWWWXWWWWW
XXXAXXXAXXXXXXXAX
XWWWCWWXWXXWWWWWW
XWWWXWWXWAXWWWWWW
XWWWXWWXWXWWWWWWW
XWWWAWWWWXXWWWWWW
SWWWXXXXXXXWWWWWW

